S.##.....T
#..#..###.
#.###.###.
#E....###.
###T#####G
